63 57
59 26
47 32
#.######....#...##..###.#.##.#..#####.#.......#.....##..#
.#######.##.#....##.#.####.#..#.....#.#.#.##...#...####..
##...#.#....##..#....####...#.#..#..#...#...##.##..#.....
#..##.#.##.#...#..###..####..###.###.###.#.##.###..#..##.
.#.........#.#..#.###..#.####....##.#.#####.##..#.#..####
....##.####..#.##..######.####..###...#.###.###....##.###
.###...#...##.#...####.##.#...##...#..#...##...##..##...#
#####.####.###..#..##.#..###..####..#.#.#.##.....###.#.##
.#.#.#.##..###..####.#........#......###....#...#.#.#.###
..###..##.#...#####.##.#......##..#......##.#..##..##.##.
#.#..#.##...###.##..###.##.#.##..#..#..###.#...#.##.##...
#...##..#...##.#.#..###.########.###..######...#.##...##.
##..###.#.#...#.##....##.#.####.....#.###.#....###.#.#.##
.#...##..........#...##.#....###.#.#..#..#.##....##.#.###
####..#.##.#..#######.##...#..#######....#####..#..#.....
.....#..#.........#..#..#......##.##....###...##..#..#...
#..###.#.###.#...##.##.####.########.##.##..#.###.####...
#.#..#..###..........##.#...#.#.#...##.##...#.#..#.#.#.##
###...#..#..#.##.#.########.......#..#.#####.#..#..#.....
###...##.##...###..###.#.#.###.#.##..#..###.#..#..#.###..
..#.#.....#####.##...#..#.###.##.##.#..###.###.##..####.#
.##.###.###.#.......##.#..##.....#....#....#..#.###..#.##
.#.#.....#########.#.#..##.#######.###...##.#.#.##..##..#
#####..#....###.##..#.#..#....##.#.####...##..#..#.#.###.
##..###.###..#.#.#.#.##..#....#.###..#.##...##..##..###.#
#.#.#.#.#.#.##.#....#...#.####..#..#.#.##.#..#.#..####.#.
##...##.###.#..##..###..#..###.#.#...#####.##.####..#.#.#
#.##..#..##...##.##.#.#######.#.#.#..#.###..#......#...#.
.##.###...##..####.##......#######..#.#..#.##.##...#.#.#.
#..##.##.#..##.##.#....#.##..#.#..##..#.###.##.###..#.#..
#.#..#####.###.#....####.....#.#.#..#..###.#.......#.#.##
##.......#.#.###..###.#.###..#.#..##.....#..##.#..##.....
.#.##.#.#..####.....###..#.#......#.#.#.###........###.##
###..##....##.#.#......#.....#..#..##...#..##.#.##.###...
##.#.##.#.#.#.####.#..##.##...#.#####..##..############.#
##.#.#.#.##..##.##.###..#.#.######..#...###....#.##..#..#
#..#.#..#...##.#.###.##..#.#..##....#........#...##..##.#
###.##..#.##..###.#.###.#######...##..##.#.#.#.##.####.##
#######..###.###.###.#.#.#.###..##...#..#.#.#.#####..#.##
####....###...##..#.#.#..#...#.##########......##.#....##
..###....#.#####..######..#.##...##.##..#..#.####.#..####
.##.##...##.##..###..#..#...##..###..#..#.##..##.###....#
#.##.####.#.###.######..#.#...#..#.##.##.###....#.##.##..
#.#.##..##..#...###..###..###.#..#...#.#.#...#..#.#######
###.#..#.##.#.#####..#.....###..#..#....##...#..#..#..###
#.#.#.##....####.....#..##.......#..##.##....#.#####..##.
.#...###.....####.##.#.##.........#...##.#..#######.#.#.#
#..#..##.#..#.###.##..#...#.##.....##....#.########.....#
.#.####..###.##.#..##....#..##.###..####.##...#..#####.#.
..#.###.##.##.###.#..##..#..#.##..##.###.#..#####.###..##
..###...##....#.##..###.###..#..#.....##...#..#.#.#..#.#.
#.##.##.#..#.#.#.####.##.##.....#..###..#.####.#.##.##...
###.#...##..#..###.#..#.##...#.#.#.###.###...#.#....###.#
...........#.##...#.####.##.##..#...##..#...######..#.##.
#.#....#.#..##...####.....#...#..#.#...#...#.#..##.#..#.#
###..#....#....#.#...##....##.######...###..#..#.....###.
.#.###...##...##.###...............#..#....#...#....####.
#.##..#.#...###.#####.#..#.#.##...#..#.#....#..###..#####
##.#....###.##.####.####....#.##.#.#.#..###.##.#.##..#.#.
....###..#.#.#.###.....#.#...##.#..#..##.###.#########..#
#.#..#....##..#####..#####.#.##.#....#.###...#..####..#..
.#.##...#.#.##..###..###.##....#..###...##...#.##....###.
...#.##..##..#####.#.#.#.#..#.##..#...####.##.#.###...#..
